RRRRRRRRRRRRRRRRRRRR
RRRRRRNNNNNNNNNNNNNR
RNNNNNNNNNNNNNNNNNNR
RNNNNNNNNNNNNNNNNNNR
RNNNNNNNNNNNNNNNNNNR
RNNNNNNNNNNNNNNNNNNR
RNNNNNNNNNNNNNNNNNNR
RNNNNNNNNNNNNNNNNNNR
RNNNNNNNNNNNNNNNNNNR
RNNNNNNNNNNNNNNNNNNR
RNNNNNNNNNNNNNNNNNNR
RNNNNNNNNNNNNNNNNNNR
RNNNNNNNNNNNNNNNNNNR
RNNNNNNNNNNNNNNNNNNR
RNNNNNNNNNNNNNNNNNNR
RNNNNNNNNNNNNNNNNNNR
RNNNNNNNNNNNNNNNNNNR
RNNNNNNNNNNNNNNNNNNR
RNNNNNNNNNNNNNNNNNNR
RRRRRRRRRRRRRRRRRRRR
